00000000000000000000
01111111111111111110
01112221111111211110
01112222221111221110
01111110221111221110
01111110111112221110
01111110111111211110
01111110111111111110
01111110111111133330
01111110111111331110
01111110111133311110
01111110111331111110
03331111111311111110
01132222221311111110
01133333333311111110
01111111111111111110
01111111111111111110
01111111111111111110
01111111111111111110
00000000000000000000
